R 800 800
NO ./texture/direction/std_wall_n.xpm
SO ./texture/direction/std_wall_s.xpm
WE ./texture/direction/std_wall_w.xpm
EA ./texture/direction/std_wall_e.xpm
S ./texture/barrel.xpm
C 0,200,0
F 00,0,60

        1111111111111111111111111
        1000000000110000022200001
        1011000001110000022200001
        1001000000000000000000001
11111111101100000111000000N000001
100000000011000001110111101111111
11110111111111011100000010001
11110111111111011101010010001
11000000110101011100000010001
10002000000000001100000010001
10000000000000011010100100001
110000011101010111110111100111
11110111 1110101 101111010001
11111111 1111111 111111111111
