R 700 700
NO ./texture/pics/mossy1.xpm
SO ./texture/pics/mossy1.xpm
WE ./texture/pics/mossy1.xpm
EA ./texture/pics/mossy1.xpm
S ./texture/xmas/tree.xpm
F 220,100,0
C 0,30,0

1111111111111111111111111111111111
1111111111111111111111111111111111
11FFFFFFFFFFFFFFFFFFFFFFFFFFFFFF11
11F8FFFFFFFFFFFFFFFFFFFFFFFFFF8F11
11FFFFFFFFFFFFFFFFFFFFFFFFFFFFFF11
11FFFFFFFFFFFFFFFFFFFFFFFFFFFFFF11
11FFFFFFFFFFFFFFFFFFFFFFFFFFFFFF11
11FFFFFFFFFFFFFFFFFFFFFFFFFFFFFF11
11FFFFFFFFFFFFFFFFFFFFFFFFFFFFFF11
11FFFFFFFFFFFFFFFFFFFFFFFFFFFFFF11
11FFFFFFFFFFFFFFFFFFFFFFFFFFFFFF11
11FFFFFFFFFFFFFFFFFFFFFFFFFFFFFF11
11FFFFFFFFFFFFFFFFFFFFFFFFFFFFFF11
11FFFFFFFFFFFFFFFFFFFFFFFFFFFFFF11
1100000000000000000000000000000011
1100000000000000000000000000000011
11111111111111111D1111111111111111
1111111111111111101111111111111111
                101               
                1N1               
                111               
