R 700 700
NO ./texture/pics/mossy1.xpm
SO ./texture/pics/mossy1.xpm
WE ./texture/pics/mossy1.xpm
EA ./texture/pics/mossy1.xpm
S ./texture/xmas/tree.xpm
F 220,100,0
C 0,30,0

 1111111111111111111111
 1320000000000000000021
 1320000008000000000001
 1300000F000000020000211111
 13208000000002100000010001
 13000F000000002000F0010S01
 13000000000000000080010001
 1300000F000000000F00010221
 13000000000000000000010001
 13000000000001200000010001
 13000002000002000800011D11
 1308000100000000000010001
 13000F02000000000000210001
11300000000000000011H11FFF1
133000000000010000102010001
111111000000020000200010001
133300008000000000100013331
13330000000000000011D113331
11310000F000000001100013331
100000000000000001100003331
100011200020111111100013331
111111111111111111111111111
