R 750 750
NO ./texture/pics/mossy1.xpm
SO ./texture/pics/mossy1.xpm
WE ./texture/pics/mossy1.xpm
EA ./texture/pics/mossy1.xpm
S ./texture/barrel.xpm
F 220,100,0
C 225,30,100
 1111111111111111111111
 1300000000000000000001
 1300800000000010000001
 1300000008000000000001
 1300000000000000080001
 1300000100001000000001
 1300200000000000000001
11300000000000000011111
13300000000010000010001
111111000000000000H2W01
13330000800002000010001
13330000000000000010111
11310000000000111110111
12000000000000000000001
10001101000011111000001
11111111111111111111111


