R 700 800
NO ./texture/pics/mossy1.xpm
SO ./texture/pics/mossy1.xpm
WE ./texture/pics/mossy1.xpm
EA ./texture/pics/mossy1.xpm
S ./texture/dead_sp_black.xpm
F 220,100,0
C 0,30,0
           111111
        111100001111
      1110000000000111
     110000000000000011
    11000000000000000011
   1100002220000222000011
  110000021208002120000011
  100000022200002220000001
 11000000000000000000000011
 10002220000008000002220001
 10002120000022200002120001
1100022200000212000022200011
1000000000000222000000000001
1000000008000000000008000001
1000008000000000008000000001
1000000000002220000000000001
1100022200002120000022200011
 10002120000222000002120001
 10002220000080000002220001
 110000000000N0000000000011
  100000022200002220000001
  110000021200802120000011
   1100002220000222000011
    11000000000000000011
     110000000000000011
      1110000000000111
        111100001111
           111111
