R 700 700
NO ./texture/pics/mossy1.xpm
SO ./texture/pics/mossy1.xpm
WE ./texture/pics/mossy1.xpm
EA ./texture/pics/mossy1.xpm
S ./texture/dead_sp_black.xpm
F 220,100,0
C 0,30,0

 1111111111111111111111
 1322222000000000000221
 1320000008000000000221
 1320000F000002220002211111111
 13208000000002120000210000001
 13000F000000022200F00100S0001
 13000000000000000080010000001
 1300000F000000000F000100F0001
 130000000000222000000100F0001
 13000000000021200000010000001
 13000022200022200800010000801
 13080021200000000000011000001
 13000F22200000000000210000001
11300000000022200011H110000001
133000000000212000102010000001
111111000000222000200010000001
1333000080000000001000100000F1
10000000000000000011D1100000F1
11010000F0000000011000100000F1
1000000000000000011000000000F1
10001122222211111110001FFFFFF1
111111111111111111111111111111
