R 700 800
NO ./texture/pics/mossy1.xpm
SO ./texture/pics/mossy1.xpm
WE ./texture/pics/mossy1.xpm
EA ./texture/pics/mossy1.xpm
S ./texture/dead_sp_black.xpm
F 220,100,0
C 0,30,0
1111111111111111111111111111
1000100011111000DDD100010001
10E0D000DDDDD000DDD000000D01
1000100011111000DDD100010001
111111D11111111111111D111111
     1000000010000010001
     1000000010000011D11
     10000000D00D00D0001
     1001D10010000011D11
     1000000010000010001
     1000000011111110001
     100000001     10001
     111111111     10001
                   11111
