R 700 800
NO ./texture/pics/mossy1.xpm
SO ./texture/pics/mossy1.xpm
WE ./texture/pics/mossy1.xpm
EA ./texture/pics/mossy1.xpm
S ./texture/dead_sp_black.xpm
F 220,100,0
C 0,30,0
    111111111111
    120000000021
    100000000001
    100000000001
1111100000800001
1000100000000001
10S01000008000011111
10001000000000010001
10201000000000012001
12021200000000210001
100011D1111111133111
100010001000100331
1000D002H200D00331
12FF10001000100331
111111111111111111
