R 800 800
NO ./texture/pics/mossy1.xpm
SO ./texture/pics/mossy1.xpm
WE ./texture/pics/mossy1.xpm
EA ./texture/pics/mossy1.xpm
S ./texture/barrel.xpm
F 220,100,0
C 0,30,0
11111111111111111111111
18888888888888888888881
18000000000000000000081
180FFFFFFFFFFFFFFFFF081
180FFFFFFFFFFFFFFFFF081
180FFFFFFFFFFFFFFFFF081
18000000000000000000081
18000000000000000000081
18000000000000000000081
18000000000000000000081
18000000000000000000081
1800000000S000000000081
18000000000000000000081
18000000000000000000081
18000000000000000000081
18000000000000000000081
18000000000000000000081
180FFFFFFFFFFFFFFFFF081
180FFFFFFFFFFFFFFFFF081
180FFFFFFFFFFFFFFFFF081
18000000000000000000081
18888888888888888888881
11111111111111111111111
