R 800 800
NO ./texture/pics/mossy1.xpm
SO ./texture/pics/mossy1.xpm
WE ./texture/pics/mossy1.xpm
EA ./texture/pics/mossy1.xpm
S ./texture/dead_sp_black.xpm

F 220,100,0
C 0,30,0

111111111111
180000000081
100000000001
100000000001
100000000001
100000000001
100000N00001
100000000001
100000000001
100000000001
180000000081
111111111111
