R 700 800
NO ./texture/pics/mossy1.xpm
SO ./texture/pics/mossy1.xpm
WE ./texture/pics/mossy1.xpm
EA ./texture/pics/mossy1.xpm
S ./texture/dead_sp_black.xpm
F 220,100,0
C 0,30,0

 1111111111111111111111
 1322222000000000000221
 1320000008000000000221
 1320000F000002220002211111
 13208000000002120000210001
 13000F000000022200F0010S01
 13000000000000000080010001
 1300000F000000000F00010221
 13000000000022200000010001
 13000000000021200000010001
 13000022200022200800011D11
 13080021200000000000010001
 13000F22200000000000210001
11300000000022200011H11FFF1
133000000000212000102010001
111111000000222000200010001
133300008000000000100013331
13330000000000000011D113331
11310000F000000001100013331
100000000000000001100003331
100011222222111111100013331
111111111111111111111111111
